##########
#.R..R...#
#...#.####
#.R.#..P.#
##########