1111111111
10C00C0001
1000101111
10C0100P01
1111111111