1111111111
1C000C00C1
1E00111111
1C0010C0P1
1111111111