1111111111
1P000000E1
1001110001
100C01101
1111111111