1111111111
11100C00C1
1E00111111
111000C0P1
1111111111